BBBBBBBBBBBBBBBBBBBBBBBBBBBBBBBBBBBBBBBBBBBBBBBBBBBBBBBBBBBBBBBBBBBBBBBBBBBBBBBBBBBBBBBBBBBBBBBBBBBB
BGGGGGGGGGGGGGGGGGGGGGGGGGGGGGGGGGGGGGGGGGGGGGGGGGGGGGGGGGGGGGGGGGGGGGGGGGGGGGGGGGGGGGGGGGGGGGGGGGGB
BGGGGGGGGGGGGGGGGGGGGGGGGGGGGGGGGGGGGGGGGGGGGGGGGGGGGGGGGGGGGGGGGGGGGGGGGGGGGGGGTTGGGGGGGGGGGGGGGGGB
BGGGGGTTGGGGGGGGGGGGGGGGGGGGGGGGGGGGGGGGGGGGGGGGGGGGGGGGGGGGGGGGGGGGGGGGGGGGGGGGGGGGGGGGGGGGGGGGGGGB
BGGGGGGGGGGGGGGGGGGGGTTTGGGGGGGGGGGGGGGGGGGGGGGGGGGGGGGGGGGGGGGGTTTGGGGGGGGGGGGGGGGGGGGGGGGGGGGGGGGB
BGGGGGGGGGGGGGGGGGGGGGGGGGGGGGGGGGGGGGGGGGGGGTGGGGGGGGGGGGGGGGGGGGGGGGGGGGGGGGGGGGGGGGGGGGGGGGGGGGGB
BGGGGGGGGGGGGGGGGGGGGGGGGGGGGGGGGGGGGGGGGGGGGGGGGGGGGGGGGGGGGGGGGGGGGGGGGGGGGGGGGGGTTTGGGGGGGGGGGGGB
BGGGGGGGGGGGGGGGGGGGGGGGGGGGGGGGGGGGGGGGGGGGGGGGGGGGGGGTTGGGGGGGGGGGGGGTTGGGGGGGGGGGGGGGGGGGGGGGGGGB
BGGGGGGGGTTTTTGGGGGGGGGGGGGGGGGGGGGTTTGGGGGGGGGGGGGGGGGGGGGGGGGGGGGGGGGGGGGGGGGGGGGGGGGGGGGGGGGGGGGB
BGGGGGGGGGGGGGGGGGGGGGGGGGGGGGGGGGGGGGGGGGGGGGGGGGGGGGGGGGGGGGGGGGGGGGGGGGGGGGGGGGGGGGGGGGGGGGGGGGGB
BGGGGGGGGGGGGGGGGGGGGGGGGGGGGGGGGGGGGGGGGGGGGGGGGGGGGGGGGGGGGGGGGGGGGGGGGGGGGGGGGGGGGGGGGGGGGGGGGGGB
BGGGGGGGGGGGGGGGGGGGGGGGGGGGGGGGGGGGGGGGGGGGGGGGGGGGGGGGGGGGGGGGGGSSSGGGGGGGGGGGGGGGGGGGGGGGGGGGGGGB
BGGGGGGGGGGGGGGGGGGGGGGGGGGGGGGGGGGGGGGGGGGGGGGGGGGGGGGGGGGGGGSSSSSSSSSSSGGGGGGGGGGGGGGGGGGGGGGGGGGB
BGGGGTTGGGGGGGGGGGGGGGGGGGGGGGGGGGGGGGGGGGGGGGGGGGGGGGGGSSSSSSSSSSSSSSSSSSSSSSSSGGGGGGGGGGGGGGGGGGGB
BGGGGGGGGGGGGGGGGGGGGGGGGGGWWWWGGWWWWGGGGGGGGGGGGGGGGGGGGGGGGSSSSGGGGGGGGGGGGGGGGGGGGGGGGGGGGGGGGGGB
BGGGGGGGGGGGGGGGGGGGGGGGWWWWGGGGGGMMMMMGGGGGGGGGGGGGGGGGGGGGGGGSSGGGGGGGGGGGGGGGGGGGGGGGGGGGGGGGGGGB
BGGGGGGGGGGGGGGGGGGGGGGGWWWGGGGGGGGGGGMMMMMGGGGGGGGGGGGGGGGGGGGGGGGGGGGGGGGGGTTGGGGGGGGGGGGGGGGGGGGB
BGGGGGGTTTGGGGGGGGGGGGWWWWGGGGGGGGGGGGGGGMMMMGGGGGGGGGGGGGGGGGGGGGGGGGGGGGGGGGGGGGGGGGGGGGGGGGGGGGGB
BGGGGGGGGGGGGGGGGGGGGGGGGGGGGGGGGGGTTTTTTTGGMMMMGGGGGGGGGGGGGGGGGGGGGGGGGGGGGGGGGGGGGGGGGGGGGGGGGGGB
BGGGGGGGGGGGGGGGGGGGGGGGGGGMMMMMGGGTTTTTTTTGGGGMMMMGGGGGGGGGSGGGGGGGGGGGGGGGGGGGGGGGGGGGGGGGGGGGGGGB
BGGGGGGGGGGGGGGGGGGGGGGGGGGGMMMMMGGGTTTTTTGGGGMMMGGGGGGGGGGGSGGGGGGGGGGGGGGGGGGGGGGGGGGGGGGGGGGGGGGB
BGGGGGGGGGGGGGGGGGGGGGGGGGGGGGMMMMMGGGGTTTGGMMMMMMMMGGGGGGGGSGGGGGGGGGGGGGGTTTTTGGGGGGGGGGGGGGGGGGGB
BGGGGGGGGGGGGGGGGGGGGGGGGGGGGGGGGMMMMMGGGGGMMMMGGGGGGGGGGGGGSGGGGGGGGGGGGGGGGGGGGGGGGGGGGGGGGGGGGGGB
BGGGGGGGGGGGGGGGGGGGGGGGGGGGGGGGGGGGMMMMMMMMGGGGGGGGGGGGGGGGSGGGGGGGGGGGGGGGGGGGGGGGGGGGGGGGGGGGGGGB
BGGGGGGGGGGGGGGGGGGGGGGGGGGGGGGGGGGGGGMMMMMMMGGGGGGGGGGGGGGGSGGGGGGGGGGGGGGGGGGGGGGGGGGGGGGGGGGGGGGB
BGGGGGGGGGGGGGGGGGGGGGGGGGGGGGGGGGGGGGGGGGGGGGGGGGGGGGGGGGGGSGGGGGGGGGGGGGGGGGGGGGGGGGGGGGGGGGGGGGGB
BGGGGGGGGGGGGGGGGGSSSSSSSSSGGGGGGGGGGGGGGGGGGGGGGGGGGGGGGGGGSGGGGGGGGGGGGGGGGGGGGGGGGGGGGGGGGGGGGGGB
BGGGGGGGGGSSSSSSSSSSSSSSSSSSSSSSSSSSGGGGGGGGGGGGGGGGGGGGGGGGSGGGGGGGGGGGGGGGGGGGGGGGGGGGGGGGGGGGGGGB
BGGGGGGGGGGGGGGGGGGSSSSSSSGGGGGGGGGGGGGGGGGGGGGGGGGGGGGGSSSSSSSSSSSSSSSSSSSSSSGGGGGGGGGGGGGGGGGGGGGB
BGGGGGGGGGGGGGGGGGGGGSSSSGGGGGGGGGGGGGGGGGGGGGGGGGGGGGGGGGGGGGGGGGGGGSSSSSSSSGGGGGGGGGGGGGGGGGGGGGGB
BGGGGGGGGGGGGGGGGGGGGGGSGGGGGGGGGGGGGGGGGGGGGSSSSSSSSGGGGGGGGGGGGGGGGGGGGGGGGGGGGGGGGGGGGGGGGGGGGGGB
BGGGGGGGGGGGGGGGGGGGGGGSGGGGGGGGGGGGGGGGGGGGGGGGGGGGGGGGGGGGGGGGGGGGGGGGGGGGGGGGGGGGGGGGGGGGGGGGGGGB
BGGGGGGGGGGGGGGGGGGGGGGSGGGGGGGGGGGGGGGGGGGGGGGGGGGGGGGGGGGGGGGGGGGGGGGGGGGGGGGGGGGGGGGGGGGGGGGGGGGB
BGGGGGGGGGGGGGGGGGGGGGGGGGGGGGGGGGGGGGGGGGGGGGGGGGGGGGGGGGGGGGGGGGGGGGGGGGGGGGGGGGGGGGGGGGGGGGGGGGGB
BGGGGGGGGGGGGGGGGGGGGGGGGGGGGGGGGGGGGGGGGGGGGGGGGGGGGGGGGGGGGGGGGGGGGGGGGGGGGGGGGGGGGGGGGGGGGGGGGGGB
BGGGGGGGGGGGGGGGGGGGGGGGGGGGGGGGGGGGGGGGGGMMMMMMMMMMMMMMMMMMMMMMMMMMMMMMMMMMMMMMMMMMMMMMMMGGGGGGGGGB
BGGGGGGGGGGGGGGGGGGGGGGGGGGGGGGGGGGGGGGGGGGGGGGGGGGGGGGGGGGGGGGGGGGGGGGGGGGGGGGGGGGGGGGGGGGGGGGGGGGB
BGGGGGGTTTTTTTTTGGGGGGGGGGGGGGGGGGGGGGGGGGGGGGGGGGGGGGGGGGGGGGGGGGGGGGGGGGGGGGGGGGGGGGGGGGGGGGGGGGGB
BGGGGGGTTTTTTTTTTGGGGGGGGGGGGGGGGGGGGGGGGGGGGGGGGGGGGGGGGGGGGGGGGGGGGGGGGGGGGGGGGGGGGGGGGGGGGGGGGGGB
BGGGGGGTTTTTTTTTTGGGGGGGGGGGGGGGGGGGGMMMMGGGGGGGGGGGGGGGGGGGGGTTTTTTTTGGGGGGGGGGGGGGGGGGGGGGGGGGGGGB
BGGGGGGTTTTTTTTTTGGGGGGGGGGGGGGGGGGGGGGSGGGGGGGGGGGGGGGGGGGGGGGGGGGGGGGGGGGGGGGGGGGGGGGGGGGGGGGGGGGB
BGGGGGGGGGGGGGGGGGGGGGGGGGGGGGGGGGGGGMMMGGGGGGGGGGGGGGGGGGGGGGGGGGGGGGGGGGGGGGGGGGGGGGGGGGGGGGGGGGGB
BGGGGGGGGGGGGGGGGGGGGGGGGGGGGGGGGGGGGGSGGGGGGGGGGGGGGGGGGGGGGGGGGGGGGGGGGGGGGGGGGGGGGGGGGGGGGGGGGGGB
BGGGGGGGGGGGGGGGGGGGGGGGGGGGGGGGGGGGGMMMMGGGGGGGGGGGGGGGGGGGGGGGGGGGGGGGGGGGGGGGGGGGGGGGGGGGGGGGGGGB
BGGGGGGGGGGGGGGGGGGGGGGGGGGGGGGGGGGGGMMMGGGGGGGGGGGGGGGGGGGGGGGGGGGGGGGGGGGGGGGGGGGGGGGGGGGGGGGGGGGB
BGGGGGGGGGGGGGGGGGGGGGGGGGGGGGGGGGGGGGGGGGGGGGGGGGGGGGGGGGGGGGGGGGGGGGGGGGGGGGGGGGGGGGGGGGGGGGGGGGGB
BGGGGGGGGGGGGGGGGGGGGGGGGGGGGGGGGGGGGGGGGGGGGGGGGGGGGGGGGGGGGGGGGGGGGGGGGGGGGGGGGGGGGGGGGGGGGGGGGGGB
BGGGGGGGGGGGGGGGGGGGGGGGGGGGGGGGGGGGGGGGGGGGGGGGGGGGGGGGGGGGGGGGGGGGGGGGGGGGGGGGGGGGGGGGGGGGGGGGGGGB
BGGGGGGGGGGGGGGGGGGGGGGGGGGGGGGGGGGGGGGGGGGGGGGGGGGGGGGGGGGGGGGGGGGGGGGGGGGGGGGGGGGGGGGGGGGGGGGGGGGB
BGGGGGGGGGGGGGGGGGGGGGGGGGGGGGGGGGGGGGGGGGGGGGGGGGGGGGGGGGGGGGGGGGGGGGGGGGGGGGGGGGGTTTTTGGGGGGGGGGGB
BGGGGGGGGGGGGGGGGGGGGGGGGGGGGGGGGGGGGGGGGWWWWWWWWWWWWWWGGGGGGGGGGGGGGGGGGGGGGGGGGGGGGGTTTGGGGGGGGGGB
BSSSSSSGGGGGGGGGGGGGGGGGGGGGGGGGGGGGGGGGGGGGWWWWWWWWWWWWWWWWWGGGGGGGGGGGGGGGGGGGGTTTTTGGGGGGGGGGGGGB
BGGGGWWWWWWWWWWWWWWGGGGGGGGGGGGGGGGGGGGGGGGGGGGWWWWWWWWWWWWWWWWWGGGGGGGGGGGGGGGGGGTTTGGGGGGGGGGGGGGB
BGGGGGGGGGGGGGGGGGWGGGGGGGGGGGGGGGGGGGGGGGGGGGGGWWWWWWGGGGGGGGGGGGGGGGGGGGGGGGGGGGGGGGGGGGGGGGGGGGGB
BWWWWWWWWWGGGGGGGGWGGGGGGGGTTTTTGGGGGGGGGGGGGGGGWWWWWWGGGGGGGGGGGGGGGGGGGGGGGGGGGGGGGGTTTTGGGGGGGGGB
BTTTTTTTTTGGGGGGGGWGGGGGGGGGGGGGGGGGGGGGGGGGGGGGGWWWWWGGGGGGGGGGGGGGGGGGGGGGGGGGGGGGGGGGGGGGGGGGGGGB
BTTTTTTTTTGGGGGGGGWGGGGGGGGGGGGGGGGGGGGGGGGGGGGGGGSSGGGGGGGGGGGGGGGGGGGGGGGGGGGGGGGGGGGGGGGGGGGGGGGB
BTTTTTTTTTGGGGGGGGWGGGGGGGGGGGGGGGGGGGGGGGGGGGGWWWWWWWWGGGGGGGGGGGGGGGGGGGGGGGGGGGGGGGGGGGGGGGGGGGGB
BTTTTTTTTTGGGGGGGGWGGGGGGGGGGGGGGGGGGGGGGGGGWWWWGGGGGGWWWWWWWWWWWWWWWWWWWGGGGGGGGGGGGGGGGGGGGGGGGGGB
BWWWWWWWWWGGGGGGGGWGGGGGGGGGGGGGGGGGGGGGGGGGGGWWWWWWWWWWWWGGGGGGGGGGGGGGGGGGGGGGGGGGGGGGGGGGGGGGGGGB
BGGGGGGGGGGGGGGGGGWGGGGGGGGGGGGGGGGGGGGGGGGGGGGGWWWWGGGGGGGGGGGGGGGGGGGGGGGGGGGGGGGGGGGGGGGGGGGGGGGB
BGGGGWWWWWWWWWWWWWWGGGGGGGGGGGGGGGGGGGGGGGGGGGGGGWWWWGGGGGGGGGGGGGGGGGMMGGTTTGGGGGGGGGGGGGGGGGGGGGGB
BSSSSSGGGGGGGGGGGGGGGGGGGGGGGGGGGGGGGGGGGGGGGGGGGGWWGGGGGGGGGGGGGGTTTTGGGGGGGGGGGGGGGGGMMMMMGGGGGGGB
BGGGGGGGGGGGGGGGGGGGGGGGGGGGGGGGGGGGGGGGGGGGGGGGGWWWGGGGGGGGGGGGGGGGGGGGMMMMGGGGGGGGGGGGGGGGGGGGGGGB
BGGGGGGGGGGGGGGGGGGGGGGGGGGGGGGGGGGGGGGGGGGGGGGGGGGGGGGGGGGGGGGGGGGGGGGGGGMMMMGGGGGGGGGGGGGGGGGGGGGB
BGGGGGGGGGGGGTTTTTTGGGGGGGGGGGGTTGGGGGGGGGGGGGGGGTTTGGGGGMMMMGGGGGGGMMMGGGGGGGGGGGGTTTGGGGGGGGGGGGGB
BGGGGGGGGGGGGGGTTTGGGGGGGGGGGGGGGGGGGGGGGGGGGGGGGGGGGGGGGGGGGGGGGGGGGGGGGGGGGGGGGGGGGGGGGGGGGGGGGGGB
BGGGGGGGGGGGGGGGTTTGGGGGGGGGGGGGGGGGGGGGGGGGGGGGGGGGGGGGGGGGGGGGGGGGGGGGGGGGGGGGGGGGGGGGGGGGGGGGGGGB
BGGGGGGGGGGGGGGGTTTGGGGGGGGGGGGGGGGGGGGGGGGGGGGGGGGGGGGGGGGGGGGGGGGGGSSSGGGGGGGGGGGGGGGGGGGGGGGGGGGB
BGGGGGGGGGGGGGGGGGGGGGGGGGGGGGGGGGGGGGGGGGGGGGGGGGTTTGGGGGGGGGGGGSSSSSSSSSSSGGGGGGGGGGGGGGGGGGGGGGGB
BGGGGGGGGGGGGGGGGGGGGGGGGGGGGGGGGGGGGGGGGGGGGGGGGGGGGGGGSSSSSSSSSSSSSSSSSSSSSSSSGGGGGGGGGGGGGGGGGGGB
BGGGGGGGGGGGGGGGGGGGGGGGGGGWWWWGGWWWWGGGGGGGGGGGGGGGGGGGGGGGGSSSSGGGGGGGGGGGGGGGGGGGGGGGGGGGGGGGGGGB
BGGGGGGGGGGGGGGGGGGGGGGGWWWWGGGGGGMMMMMGGGGGGGGGGGGGGGGGGGGGGGGSSGGGGGGGGGGGGGGGGGGGGGGGGGGGGGGGGGGB
BGGGGGGGGGGGGGGGGGGGGGGGWWWGGGGGGGGGGGMMMMMGGGGGGGGGGGGGGGGGGGGGGGGGGGGGGGGGGGGGGGGGGGGGGGGGGGGGGGGB
BGGGGGGGGGGGGGGGGGGGGGWWWWGGGGGGGGGGGGGGGMMMMGGGGGGGGGGGGGGGGGGGGGGGGGGGGGGGGGGGGGGGGGGGGGGGGGGGGGGB
BGGGGGTTTTTGGGGGGGGGGGGGGGGGGGGGGGGTTTTTTTGGMMMMGGGGGGGGGGGGGGGGGGGGGGGGGGGGGGGGGGGGGGGGGGGGGGGGGGGB
BGGGGGGGGGGGGGGGGGGGGGGGGGGMMMMMGGGTTTTTTTTGGGGMMMMGGGGGGGGGGGGGGGGGGGGGGGGGGGGGGGGGGGGGGGGGGGGGGGGB
BGGGGGGGGGGGGGGGGGGGGGGGGGGGMMMMMGGGTTTTTTGGGGMMMGGGGGGGGGGGGGGGGGGGGGGGGGGGGGGGGGGGGGGGGGGGGGGGGGGB
BGGGGGGGGGGGGGGGGGGGGGGGGGGGGGMMMMMGGGGTTTGGMMMMMMMMGGGGGGGGGGGGGGGGGGGGGGGTTTTTGGGGGGGGGGGGGGGGGGGB
BGGGGGGGGGGGGGGGGGGGGGGGGGGGGGGGGMMMMMGGGGGMMMMGGGGGGGGGGGGGGGGGGGGGGGGGGGGGGGGGGGGGGGGGGSSSSSGGGGGB
BGGGGGGGGGGGGGGGGGGGGGGGGGGGGGGGGGGGMMMMMMMMGGGGGGGGGGGGGGGGGGGGGGGGGGGGGGGGGGGGGGGGGGGGGGGGGGGGGGGB
BGGGGGGGGGGGGGGGGGGGGGGGGGGGGGGGGGGGGGMMMMMMMGGGGGGGGGGGGGGGGGGGGGGGGGGGGGGGGGGGGGGGGGGGGGGGGGGGGGGB
BGGGGGGGGGGGGGGGGGGGGGGGGGGGGGGGGGGGGSSSSSSSSSSSSSSSSSSGGGGGGGGGGGGGGGGGGGGGGGGGGSSSSSSSSSSSSSSSSSSB
BGGGGGGGGGGGGGGGGGSSSSSSSSSGGGGGGGGGGGGGGGGGGGGGGGGGGGGGGGGGGGGGGGGGGGGGGGGGGGGGGGGGGGGGGGGGGGGGGGGB
BSSSSSSSSSSSSSSSSSSSSSSSSSSSSSSSSSSSGGGGGGGGGGGGGGSSSSSSSSSSSSSSSSSSSSSSSSSSSSGGGGGGGGGGGGGGGGGGGGGB
BGGGGGGGGGGGGGGGGGGSSSSSSSSSSSSSSSSSSSSSSSSSSSSSSSSSSSSSSSSSSSSSSSSSSSSSSSSSSSSSSSSSSSSSSSSSSSSSSSSB
BGGGGGGGGGGGGGGGGGGGGSSSSGGGGGGGGGGGGGGGGGGGGGGGSGGGGGGGGGGGGGGGGGGGGSSSSSSSSGGGGGGGGGGGGGGGGGGGGGGB
BGGGGGGGGGGGGGGGGGGGGGGSGGGGGGGGGGGGGGGGGGGGGSSSSSSSSGGGGGGGGGGGGGGGGGGSSGGGGGGGGGGGGGGGGGGGGGGGGGGB
BGGGGGGGGGGGGGGGGGGGGGGSGGGGGGGGGGGGGGGGGGGGGGGSGGGGGGGGGGGGGGGGGGGGGGGSSGGGGGGGGGGGGGGGGGGGGGGGGGGB
BGGGGGGGGGGGGGGGGGGGGGGSGGGGGGGGGGGGGGGGGGGGGGGSGGGGGGGGGGGGGGGGGGGGGGGGSSGGGGGGGGGGGGGGGGGGGGGGGGGB
BGGGGGGGGGGGGGGGGGGGGGGGGGGGGGGGGGGGGGGGGGGGGGGSGGGGGGGGGGGGGGGGGGGGGGGGGSSGGGGGGGGGGGGGGGGGGGGGGGGB
BTTTTTTTTTTTTTTTTTTTTTTTTTTTTTTTTTTTTTTTTTTTTTTTTTTTTTTTTTTTTTTTTTTTTTTTTTTTTTTTTTTTTTTTTTTTTTTTTTTB
BTTTTTTTTTTTTTTTTTTTTTTTTTTTTTTTTTTTTTTTTTTTTTTTTTTTTTTTTTTTTTTTTTTTTTTTTTTTTTTTTTTTTTTTTTTTTTTTTTTB
BTTTTTTTTTTTTTTTTTTTTTTTTTTTTTTTTTTTTTTTTTTTTTTTTTTTTTTTTTTTTTTTTTTTTTTTTTTTTTTTTTTTTTTTTTTTTTTTTTTB
BTTTTTTTTTTTTTTTTTTTTTTTTTTTTTTTTTTTTTTTTTTTTTTTTTTTTTTTTTTTTTTTTTTTTTTTTTTTTTTTTTTTTTTTTTTTTTTTTTTB
BTTTTTTTTTTTTTTTTTTTTTTTTTTTTTTTTTTTTTTTTTTTTTTTTTTTTTTTTTTTTTTTTTTTTTTTTTTTTTTTTTTTTTTTTTTTTTTTTTTB
BGGGGGGGGGGGGGGGGGGGGGGGGGGGGGGGGGGGGGGGGGGGGGGGGGGGGGGGGGGGGGGGGGGGGGGGGGGGGGGGGGGGGGGGGGGGGGGGGGGB
BGGGGGGGGGGGGGGGGGGGGGGGGGGGGGGGGGGGGGGGGGGGGGGGGGGGGGGGGGGGGGGGGGGGGGGGGGGGGGGGGGGGGGGGGGGGGGGGGGGB
BGGGGGGGGGGGGGGGGGGGGGGGGGGGGGGGGGGGGGGGGGGGGGGGGGGGGGGGGGGGGGGGGGGGGGGGGGGGGGGGGGGGGGGGGGGGGGGGGGGB
BBBBBBBBBBBBBBBBBBBBBBBBBBBBBBBBBBBBBBBBBBBBBBBBBBBBBBBBBBBBBBBBBBBBBBBBBBBBBBBBBBBBBBBBBBBBBBBBBBBB